########################
#..........#.......#...#
#.#######.##.#.#..#..#.#
#.....#.#....#.#.###.#.#
#####.#.######.#...###.#
#...#.#.....##.###.#.#.#
##.#..#####........#...#
##.##.####.###.#####.###
#...#......#.#.#..##.###
#.########.#.#.##.....##
#.#........#.#.######.##
#.#.######.#.#....##..##
#.#.#......#.####.#...##
#.#.#.####......#.#.#.##
#.#.#.#########.#.#.#.##
#.#.#.........#.#.#.#.##
#.#.#..#.##.#.#.#.#.#.##
#.#.#.#.##.#.##.#.###.##
#...#..................#
##.################.####
##.#####.....#####.....#
##.....#.#.###...#####.#
##.#.#...#.....#.......#
########################
