+----------+-----------+
|..........|...........|
|.---.|.--.|.-.|.|.---.|
|.....|........|.|.....|
+-+.|.|.------.|.|.|.+-+
  |.|.|..........|.|.|  
--+......+~~~~+......+--
....----.|....|.----....
--+......+----+......+--
  |.|.|..........|.|.|  
+-+.|.|.|.------.|.|.+-+
|.....|.|........|.....|
|.---.|.|.-.|.--.|.---.|
|...........|..........|
+-----------+----------+
