########################
#..........#.......#...#
#.#######.##.#.#..#..#.#
#.....#.#....#.#.###.#.#
#####.#.######.#...###.#
#...#.#........###.#.#.#
##.#..########.....#...#
##.##.####....##..##.###
#...#.....####.#..##.###
#.########.#.#.##.....##
#.#........#.#.######.##
#.#.######.#.#....##..##
#.#.#......#.####.#...##
#.#.#.####......#.#.#.##
#.#.#.#########.#.#.#.##
#.#.#.........#.#.#.#.##
#.#.#..#.##.#.#.#.#.#.##
#.#.#.#.##.#.##.#.###.##
#...#..................#
##.################.####
##.#####.....#####.....#
##.....#.#.###...#####.#
##.#.#...#.....#.......#
########################
